################
#H  W   P   W V#
#  I  IWWI  I  #
#  B      V B  #
#  I        I  #
#  B        B  #
#W I        I W#
#  BIIIIIIIIB  #
#  B        B  #
#W I        I W#
#  B        B  #
#  I        I  #
#  B V      B  #
#     IWWI     #
#V   W    W   H#
################