################
#B ########## B#
## #I  P   I# ##
#IVIIII IIIIIVI#
#I IIII IIIII I#
#I IIII IIIII I#
#IWIIII IIIIIWI#
#####II II######
#IIIIII IIIIIII#
#IIBIII IIIIBII#
#IW    V    H W#
#IIIIIIIIIIIIII#
#IIIBIIIIIIBIII#
###H   II   H###
#W      H     W#
################